NO maps/maze_map/HEDGE_1B.xpm
SO maps/maze_map/HEDGE_1A.xpm
WE maps/maze_map/HEDGE_1B.xpm
EA maps/maze_map/HEDGE_1A.xpm

F 0,80,0
C 50, 50, 170

1111111111111111111111111
10000000000000S0000000001
1011111111111101111111101
1010000000000101000000101
1010111101110101111010101
1010100000010100000010101
1010101111010101111010101
1010001000010000100000101
1011101010110110101011101
1000101010001000101010001
1110101110111011101110101
0010000010001000100001001
1110101110111011101110101
1000101010001000101010001
1011101010110110101011101
1010001000010000100000101
1010101111010101111010101
1010100000010100000010101
1010111101110101111010101
1010000000000101000000101
1011111111111101111111101
1000000000000000000000001
1111111111111111111111111