NO maps/FUCK_1.xpm
SO maps/FUCK_2.xpm
WE maps/FUCK_3.xpm
EA maps/FUCK_5.xpm

F 20,22,25
C 20,14,15

11111111111111111111111111111111111111111111111111111111111111111111111111111111111111111111
10000000000000000000000000000000000000000000000000000000000000000000000000000000000000000001
10011111100010001000111110001000100000010001000111110001000100000000000000000000000000000001
10010000000010001000100000001001000000001010000100010001000100000000000000000000000000000001
10011110000010001000100000001010000000000100000100010001000100000000000000000000000000000001
10010000000010001000100000001001000000000100000100010001000100000000000000000000000000000001
10010000000011111000111110001000100000000100000111110001111100000000000000000000000000000001
10000000000000000000000000000000000000000000000000000000000000000000000000000000000000000001
10000000000000000000000000000000000000000000000000000000000000000000000000000000000000000001
10000000000000000000000000000000000000000000000000000000000000000000000000000000000000000001
10010001000000010001000000000000000000000000000000000000000000000000000000000000000000000001
10010001000000010001000000000000000000000000000000000000000000000000000000000000000000000001
10010001000000010001000000000000000000000000000000000000000000000000000000000000000000000001
10010001000000010001000000000000000000000000000000000000000000000000000000000000000000000001
10011111000000011111000000000000000000000000000000000000000000000000000000000000000000000001
10000000000000000000000000000000000000000000000000000000000000000000000000000000000000000001
10000000000000000000000000000000000000000000000000000000000000000000000000000000000000000001
10011111000000000000000001111100000000000000000000000000000000000000000000000000000000000001
1001000000000000000000000100000000000000000000000000000000000000000000000000000000000000000111111111111
10010000000000000000000001000000000000000000000000000000000000000000000000000000000000000000000000000W1
1001000000000000000000000100000000000000000000000000000000000000000000000000000000000000000111111111111
10011111000000000000000001111100000000000000000000000000000000000000000000000000000000000001
10000000000000000000000000000000000000000000000000000000000000000000000000000000000000000001
10000000000000000000000000000000000000000000000000000000000000000000000000000000000000000001
10000000000000000000000000000000000000000000000000000000000000000000000000000000000000000001
10010001000000000000000000000000000001000100000000000000000000000000000000000000000000000001
10010100000000000000000000000000000001010000000000000000000000000000000000000000000000000001
10010000000000000000000000000000000001000000000000000000000000000000000000000000000000000001
10010010000000000000000000000000000001001000000000000000000000000000000000000000000000000001
10010001000000000000000000000000000001000100000000000000000000000000000000000000000000000001
10000000000000000000000000000000000000000000000000000000000000000000000000000000000000000001
10000000000000000000000000000000000000000000000000000000000000000000000000000000000000000001
10000000000000000000000000000000000000000000000000000000000000000000000000000000000000000001
10010001000000000000000000000000000000000000000010001000000000000000000000000000000000000001
10001010000000000000000000000000000000000000000001010000000000000000000000000000000000000001
10000100000000000000000000000000000000000000000000100000000000000000000000000000000000000001
10000100000000000000000000000000000000000000000000100000000000000000000000000000000000000001
10000100000000000000000000000000000000000000000000100000000000000000000000000000000000000001
10000000000000000000000000000000000000000000000000000000000000000000000000000000000000000001
10000000000000000000000000000000000000000000000000000000000000000000000000000000000000000001
10000000000000000000000000000000000000000000000000000000000000000000000000000000000000000001
10011111000000000000000000000000000000000000000000000000000000000111110000000000000000000001
10010001000000000000000000000000000000000000000000000000000000000100010000000000000000000001
10010001000000000000000000000000000000000000000000000000000000000100010000000000000000000001
10010001000000000000000000000000000000000000000000000000000000000100010000000000000000000001
10011111000000000000000000000000000000000000000000000000000000000111110000000000000000000001
10000000000000000000000000000000000000000000000000000000000000000000000000000000000000000001
10000000000000000000000000000000000000000000000000000000000000000000000000000000000000000001
10000000000000000000000000000000000000000000000000000000000000000000000000000000000000000001
10010001000000000000000000000000000000000000000000000000000000000000000000000000000010001001
10010001000000000000000000000000000000000000000000000000000000000000000000000000000010001001
10010001000000000000000000000000000000000000000000000000000000000000000000000000000010001001
10010001000000000000000000000000000000000000000000000000000000000000000000000000000010001001
10011111000000000000000000000000000000000000000000000000000000000000000000000000000011111001
10000000000000000000000000000000000000000000000000000000000000000000000000000000000000000001
10000000000000000000000000000000000000000000000000000000000000000000000000000000000000000001
10000000000000000000000000000000000000000000000000000000000000000000000000000000000000000001
11111111111111111111111111111111111111111111111111111111111111111111111111111111111111111111
