NO maps/Lab1.xpm
SO maps/Lab2.xpm
WE maps/Lab3.xpm
EA maps/Lab4.xpm

F 140,140,140
C 60,60,60

1111111111111111111111111
10000000000000000000000W1
1011111111111111111111101
1010000000000000000000101
1010000000000000000010101
1000100000000000000010101
1010000000000000000010101
1010000000000000000000101
1011111111111111111111101
1000000000000000000000001
1011111111111111111111001
1000000000000000000000001
1010111111111111111010001
1000100000000000000010001
1010111111111111111010001
1010000000000000000000101
1000000000000000000000001
1000000000000000000000001
1011111111111111111111101
1010000000000000000000101
1010000000001111100000001
1000100000000000000010001
1010111111111111111010001
1000000000000000000000001
1011111111111111111111101
1111111111111111111111111
