NO maps/HEDGE_1B.xpm
SO maps/BRICK_3D.xpm
WE maps/HEDGE_1A.xpm
EA maps/BRICK_3E.xpm

F 20,22,25
C 20,14,15

        1111111111111111111111111
        1000000000000000000000001
        1000000000000001111111111
        10000000S0000001
111111110000000000000001
10000000000000000000000011111
11111111111111110000000000001
10000000000000000000111000001
10000111111111110000000000001
10000000000000000000000000001
10000000000000011111100000001
1001111111000001    100000011
10000011 1000001    100000001
11111111 1111111    111111111
