NO maps/standard.xpm
SO maps/standard.xpm
WE maps/standard.xpm
EA maps/standard.xpm

F 100,100,100
C 200,200,200

        1111111111111111111111111
        1000000000000000000000001
        1000000000000001111111111
        100000000E000001
111111110000000000010001
10000000000000000000000011111
11111111111111110000000000001
10000000000000000000111000001
10000111111111110000000000001
10000000000000000000000000001
10000000000000011111100000001
1001111111000001    100000011
10000011 1000001    100000001
11111111 1111111    111111111
