NO maps/FUCK_1.xpm
SO maps/FUCK_2.xpm
WE maps/FUCK_3.xpm
EA maps/FUCK_5.xpm

F 20,22,25
C 20,14,15

111111111111111111111111111111111111111111111111111111111111111111111111111111
10W010001000100010000100010001000100010001000100010001000100010001000100010001
101010101010101010101010101010101010101010101010101010101010101010101010101011
100010001000100010001000100010001000100010001000100010001000100010001000100001
101010101010101010101010101010101010101010101010101010101010101010101010101011
100010001000100010001000100010001000100010001000100010001000100010001000100001
101010101010101010101010101010101010101010101010101010101010101010101010101011
100010001000100010001000100010001000100010001000100010001000100010001000100001
101010101010101010101010101010101010101010101010101010101010101010101010101011
100010001000100010001000100010001000100010001000100010001000100010001000100001
101010101010101010101010101010101010101010101010101010101010101010101010101011
100010001000100010001000100010001000100010001000100010001000100010001000100001
101010101010101010101010101010101010101010101010101010101010101010101010101011
100010001000100010001000100010001000100010001000100010001000100010001000100001
101010101010101010101010101010101010101010101010101010101010101010101010101011
100000001000100010000100010001000100000001000100010001000100000001000100010001
101011111010101010101010101010101010101011111010101010101011111010101010101011
100000001000100010000100010001000100000001000100010001000100000001000100010001
101010101010101010101010101010101010101010101010101010101010101010101010101011
100010001000100010001000100010001000100010001000100010001000100010001000100001
101010101010101010101010101010101010101010101010101010101010101010101010101011
100010001000100010001000100010001000100010001000100010001000100010001000100001
101010101010101010101010101010101010101010101010101010101010101010101010101011
100010001000100010001000100010001000100010001000100010001000100010001000100001
101010101010101010101010101010101010101010101010101010101010101010101010101011
100010001000100010001000100010001000100010001000100010001000100010001000100001
101010101010101010101010101010101010101010101010101010101010101010101010101011
100010001000100010001000100010001000100010001000100010001000100111111111111111
111111111111111111111111111111111111111111111111111111111111111
