



SO ./maps/uniao.xpm



NO ./maps/BRICK_3D.xpm


WE ./maps/HEDGE_1B.xpm





F 20,22,25




C 20,11,20

EA ./maps/HEDGE_1A.xpm

11111
100E01
11111
