EA ./maps/HEDGE_1A.xpm
SO ./maps/uniao.xpm
NO ./maps/BRICK_3D.xpm
WE ./maps/HEDGE_1B.xpm

F 128,96,67
C 0,181,226

111111111111111111111111111111111111111111111111111111111111111111111111111111111111111111111111111111111111111111111111111111111111111111111111111111111111111
100N00000000000000000000000000000000000000000000000000000000000000000000000000000000000000000000000000000000000000000000000000000000000000000000000000000000001
111111111111111111111111111111111111111111111111111111111111111111111111111111111111111111111111111111111111111111111111111111111111111111111111111111111111111
