EA maps/Lab1.xpm
SO maps/Lab2.xpm
NO maps/Lab3.xpm
WE maps/Lab4.xpm

11111111111111111111111111111111111111111111111111111111111111111111111111111111
1N000000000000000000000000000000000000000000000000000000000000000000000000000001
11111111111111111111111111111111111111111111111111111111111111111111111111111111

F 128,96,67
C 0,181,226
