EA maps/HEDGE_1A.xpm
NO maps/BRICK_3D.xpm
WE maps/HEDGE_1B.xpm

F 128,96,67
C 0,181,226

11111111111111111111111111111111111111111111111111111111111111111111111111111111
100N0000000000000000000000000000000000000000000000000000000000000000000000000001
11111111111111111111111111111111111111111111111111111111111111111111111111111111
