EA maps/Lab1.xpm
SO maps/Lab2.xpm
NO maps/Lab3.xpm
WE maps/Lab4.xpm

C 0,181,226

11111111111111111111111111111111111111111111111111111111111111111111111111111111
10N00000000000000000000000000000000000000000000000000000000000000000000000000001
11111111111111111111111111111111111111111111111111111111111111111111111111111111
